####################
#~#     #   # #    $
#   # ##   ## ## # #
# #      ##    # ###
#  ##  #    #      #
####################