####################
#  #    #   ##     #
##   #    #    # ###
###########  #    ##
#     #   ###    ###
# ## ## #    # ##  #
#     #  ## #   #  #
#  ##   # # $###  ##
##  ##### ####   ###
###   #  ~    ##  ##
#   ##### ###    ###
## #    # #   ## ###
#  #  # # # ###   ##
# ### #   #     # ##
#  ##############  #
##    # # #     ## #
# ## #    # ###    #
# #  # ## # # ##  ##
#      #    #      #
####################