####################
#  #    #   ##     #
##   #    #    # # #
###### ####  #     #
#     #   ###    # #
# ## ## #    # #   #
#     #  ## #   #  #
#  ##   # # $###  ##
##  ##### ####   ###
###   #  ~    ##  ##
#   ##### ###    ###
## #    # #   ## ###
#  #  # # # ###   ##
# ### #   #     # ##
#  ##### ###### #  #
##    # # #     ## #
# ## #    # ###    #
# #  # ## # # ##  ##
#      #    #      #
####################