####################
##  #   #   ##   ###
#     #   #    #   #
# ########  ###  # #
# ~#       ## # #  #
#### ######    # # #
##          ##   #^#
####################