####################
##  #   #   ##   ###
#     #   #    #   #
# ########  ###  # #
#  #       ## # #  #
#### ######    # #~#
##          ##   #^#
####################