####################
#   ##   #       ###
# # #   ## #####  ##
#$#   #    # #    ##
# # ######## # ##  #
# # #   #       ## #
#   # #   #####  #v#
####################