####################
#   ##   #       ###
# # #   ## #####  ##
#$#   #    # #    ##
# # ######## # ##  #
# # #   #       ##~#
#   # #   #####  #v#
####################