####################
##   #   #    #    #
## #   #   ##   ## #
##  ####  ##  ###  #
##     ##   ##   # #
#^ ### #### #  #   #
###    ##    ##  # #
# ^#########  ##  ##
# ##   #   # # ##  #
#$#~##   #   #    ##
##     ##  ##^ ## ##
####################