####################
##   #   #    #    #
## #   s   ##   ## #
##  ####  ##  ###  #
##     ##   ##   # #
#^ ### #### #  #   #
###    ##    ##  # #
# ^#######s#  ##  ##
# ##   #   # # #s  #
#$#~##   #   #    ##
##     ##  ##^ ## ##
####################