##############      
# v#    #v#  #      
# #  #  #  # #      
#  # # # #  s#      
##   #    #  #      
##### s # ## #      
#v     #     #      
##############      