##############      
# v#    #v#  #      
# #  #  #  # #      
#  # # # #   #      
##   #    #  #      
##### # # ## #      
#v     #     #      
##############      