####################
#s  ##s  #       ###
#$# #   ## ##### s##
# #   #    # #    ##
# # #####s## # ##  #
# # #   #       ## #
#   # #   #####  #v#
####################